memento mori: remember death
carpe diem: seize the day
veni, vidi, vici: I came, I saw, I conquered
amor vincit omnia: love conquers all
in vino veritas: in wine, truth
audentes fortuna iuvat: fortune favors the bold
tempus fugit: time flies
cogito, ergo sum: I think, therefore I am
et tu, Brute?: and you, Brutus?
dulce et decorum est pro patria mori: it is sweet and fitting to die for one's country
alea iacta est: the die is cast
per aspera ad astra: through hardships to the stars
acta non verba: deeds, not words
fortuna caeca est: fortune is blind
nunc est bibendum: now is the time to drink
semper fidelis: always faithful
divide et impera: divide and conquer
panem et circenses: bread and circuses
labor omnia vincit: work conquers all
nosce te ipsum: know thyself
ars longa, vita brevis: art is long, life is short
fiat lux: let there be light
ex nihilo nihil fit: nothing comes from nothing
homo homini lupus: man is a wolf to man
in medias res: into the middle of things
sine qua non: without which not (essential condition)
caveat emptor: let the buyer beware
vox populi, vox dei: the voice of the people is the voice of God
status quo: the existing state
sub rosa: under the rose (secretly)
ad astra per aspera: to the stars through difficulties
deus ex machina: god from the machine
mea culpa: my fault
veni, vidi, amavi: I came, I saw, I loved
morituri te salutant: those who are about to die salute you
non ducor, duco: I am not led, I lead
carthago delenda est: Carthage must be destroyed
tempora mutantur, nos et mutamur in illis: times change, and we change with them
amor fati: love of fate
alea iacta est: the die has been cast
omnia vincit amor: love conquers all
magnum opus: great work
in loco parentis: in the place of a parent
sui generis: of its own kind
modus operandi: method of operation
natura non facit saltus: nature does not make jumps
pro bono publico: for the public good
quod erat demonstrandum (Q.E.D.): which was to be demonstrated
res ipsa loquitur: the thing speaks for itself
sic semper tyrannis: thus always to tyrants
